1111111111
1000001001
1000111001
1000000001
1111100001
1000000001
1001000001
1001000111
1000000001
1111111111

